ArenaBase               - open class ArenaBase(parent: NativeFreeablePlacement = nativeHeap) : AutofreeScope
Arena                   - class Arena(parent: NativeFreeablePlacement = nativeHeap) : ArenaBase
AutofreeScope           - abstract class AutofreeScope : DeferScope, NativePlacement
BetaInteropApi          - @Target(allowedTargets = [AnnotationTarget.TYPEALIAS, AnnotationTarget.FUNCTION, AnnotationTarget.PROPERTY, AnnotationTarget.ANNOTATION_CLASS, AnnotationTarget.CLASS]) annotation class BetaInteropApi
BooleanVar              - typealias BooleanVar = BooleanVarOf<Boolean>
BooleanVarOf            - class BooleanVarOf<T : Boolean>(rawPtr: NativePtr) : CPrimitiveVar
ByteVar                 - typealias ByteVar = ByteVarOf<Byte>
ByteVarOf               - class ByteVarOf<T : Byte>(rawPtr: NativePtr) : CPrimitiveVar
CArrayPointer           - typealias CArrayPointer<T> = CPointer<T>
CArrayPointerVar        - typealias CArrayPointerVar<T> = CPointerVar<T>
CEnum                   - interface CEnum
CEnumVar                - abstract class CEnumVar(rawPtr: NativePtr) : CPrimitiveVar
CFunction               - class CFunction<T : Function<*>>(rawPtr: NativePtr) : CPointed
COpaque                 - abstract class COpaque(rawPtr: NativePtr) : CPointed
COpaquePointer          - typealias COpaquePointer = CPointer<out CPointed>
COpaquePointerVar       - typealias COpaquePointerVar = CPointerVarOf<COpaquePointer>
CPointed                - abstract class CPointed(rawPtr: NativePtr) : NativePointed
CPointer                - class CPointer<T : CPointed> : CValuesRef<T> 
CPointerVar             - typealias CPointerVar<T> = CPointerVarOf<CPointer<T>>
CPointerVarOf           - class CPointerVarOf<T : CPointer<*>>(rawPtr: NativePtr) : CVariable
CPrimitiveVar           - sealed class CPrimitiveVar(rawPtr: NativePtr) : CVariable
CStructVar              - abstract class CStructVar(rawPtr: NativePtr) : CVariable
CValue                  - abstract class CValue<T : CVariable> : CValues<T>
CValues                 - abstract class CValues<T : CVariable> : CValuesRef<T> 
CValuesRef              - abstract class CValuesRef<T : CPointed>
CVariable               - abstract class CVariable(rawPtr: NativePtr) : CPointed
DeferScope              - open class DeferScope
DoubleVar               - typealias DoubleVar = DoubleVarOf<Double>
DoubleVarOf             - class DoubleVarOf<T : Double>(rawPtr: NativePtr) : CPrimitiveVar
ExperimentalForeignApi  - @Target(allowedTargets = [AnnotationTarget.TYPEALIAS, AnnotationTarget.FUNCTION, AnnotationTarget.PROPERTY, AnnotationTarget.CLASS]) annotation class ExperimentalForeignApi
ExportObjCClass         - @Target(allowedTargets = [AnnotationTarget.CLASS]) annotation class ExportObjCClass(val name: String = "")
ExternalObjCClass       - @Target(allowedTargets = [AnnotationTarget.CLASS]) annotation class ExternalObjCClass(val protocolGetter: String = "", val binaryName: String = "")
FloatVar                - typealias FloatVar = FloatVarOf<Float>
FloatVarOf              - class FloatVarOf<T : Float>(rawPtr: NativePtr) : CPrimitiveVar
ForeignException        - class ForeignException : Exception
InteropStubs            - @Target(allowedTargets = [AnnotationTarget.FILE]) annotation class InteropStubs
IntVar                  - typealias IntVar = IntVarOf<Int>
IntVarOf                - class IntVarOf<T : Int>(rawPtr: NativePtr) : CPrimitiveVar
LongVar                 - typealias LongVar = LongVarOf<Long>
LongVarOf               - class LongVarOf<T : Long>(rawPtr: NativePtr) : CPrimitiveVar
MemScope                - class MemScope : ArenaBase
NativeFreeablePlacement - interface NativeFreeablePlacement : NativePlacement
nativeHeap              - object nativeHeap : NativeFreeablePlacement
NativePlacement         - interface NativePlacement
NativePointed           - open class NativePointed
NativePtr               - typealias NativePtr = kotlin.native.internal.NativePtr
ObjCAction              - @Target(allowedTargets = [AnnotationTarget.FUNCTION]) annotation class ObjCAction
ObjCBlockVar            - typealias ObjCBlockVar<T> = ObjCNotImplementedVar<T>
ObjCClass               - interface ObjCClass : ObjCObject
ObjCClassOf             - interface ObjCClassOf<T : ObjCObject> : ObjCClass
ObjCConstructor         - @Target(allowedTargets = [AnnotationTarget.CONSTRUCTOR]) annotation class ObjCConstructor(val initSelector: String, val designated: Boolean)
ObjCDirect              - @Target(allowedTargets = [AnnotationTarget.FUNCTION]) annotation class ObjCDirect(val symbol: String)
ObjCFactory             - @Target(allowedTargets = [AnnotationTarget.FUNCTION]) annotation class ObjCFactory(val selector: String, val encoding: String, val isStret: Boolean = false)
ObjCMethod              - @Target(allowedTargets = [AnnotationTarget.FUNCTION, AnnotationTarget.PROPERTY_GETTER, AnnotationTarget.PROPERTY_SETTER]) annotation class ObjCMethod(val selector: String, val encoding: String, val isStret: Boolean = false)
ObjCNotImplementedVar   - class ObjCNotImplementedVar<T>(rawPtr: NativePtr) : CVariable
ObjCObject              - interface ObjCObject
ObjCObjectBase          - abstract class ObjCObjectBase : ObjCObject
ObjCObjectBaseMeta      - abstract class ObjCObjectBaseMeta : ObjCObjectBase, ObjCClass
ObjCObjectMeta          - typealias ObjCObjectMeta = ObjCClass
ObjCObjectVar           - class ObjCObjectVar<T>(rawPtr: NativePtr) : CVariable
ObjCOutlet              - @Target(allowedTargets = [AnnotationTarget.PROPERTY]) - annotation class ObjCOutlet
ObjCProtocol            - interface ObjCProtocol : ObjCObject
ObjCSignatureOverride   - @Target(allowedTargets = [AnnotationTarget.FUNCTION]) annotation class ObjCSignatureOverride
ObjCStringVarOf         - typealias ObjCStringVarOf<T> = ObjCNotImplementedVar<T>
Pinned                  - class Pinned<T : Any>
ShortVar                - typealias ShortVar = ShortVarOf<Short>
ShortVarOf              - class ShortVarOf<T : Short>(rawPtr: NativePtr) : CPrimitiveVar
StableRef               - @JvmInline value class StableRef<out T : Any>
UByteVar                - typealias UByteVar = UByteVarOf<UByte>
UByteVarOf              - class UByteVarOf<T : UByte>(rawPtr: NativePtr) : CPrimitiveVar
UIntVar                 - typealias UIntVar = UIntVarOf<UInt>
UIntVarOf               - class UIntVarOf<T : UInt>(rawPtr: NativePtr) : CPrimitiveVar
ULongVar                - typealias ULongVar = ULongVarOf<ULong>
ULongVarOf              - class ULongVarOf<T : ULong>(rawPtr: NativePtr) : CPrimitiveVar
UnsafeNumber            - @Target(allowedTargets = [AnnotationTarget.TYPEALIAS, AnnotationTarget.FUNCTION, AnnotationTarget.PROPERTY]) annotation class UnsafeNumber(val actualPlatformTypes: Array<String>)
UShortVar               - typealias UShortVar = UShortVarOf<UShort>
UShortVarOf             - class UShortVarOf<T : UShort>(rawPtr: NativePtr) : CPrimitiveVar
Vector128               - class Vector128
Vector128Var            - typealias Vector128Var = Vector128VarOf<Vector128>
Vector128VarOf          - class Vector128VarOf<T : Vector128>(rawPtr: NativePtr) : CVariable
